date,India,Republic of Korea,Brazil,Spain,United States of America,Mexico,Germany,China,Total_cases
1/3/20,0,0,0,0,0,0,0,0,0
1/4/20,0,0,0,0,0,0,1,1,2
1/5/20,0,0,0,0,0,0,1,1,2
1/6/20,0,0,0,0,0,0,1,4,5
1/7/20,0,0,0,0,0,0,1,4,5
1/8/20,0,0,0,0,0,0,1,4,5
1/9/20,0,0,0,0,0,0,1,4,5
1/10/20,0,0,0,0,0,0,1,4,5
1/11/20,0,0,0,1,0,0,1,4,6
1/12/20,0,0,0,2,0,0,1,45,48
1/13/20,0,0,0,2,0,0,1,45,48
1/14/20,0,0,0,3,0,0,1,45,49
1/15/20,0,0,0,3,0,0,1,45,49
1/16/20,0,0,0,3,0,0,1,45,49
1/17/20,0,0,0,3,0,0,1,49,53
1/18/20,0,0,0,3,0,0,1,49,53
1/19/20,0,1,0,3,0,0,1,125,130
1/20/20,0,1,0,4,1,0,1,202,209
1/21/20,0,1,0,4,1,0,1,295,302
1/22/20,0,1,0,4,1,0,1,442,449
1/23/20,0,1,0,5,1,0,1,574,582
1/24/20,0,2,0,5,1,0,2,835,845
1/25/20,0,2,0,5,6,0,2,1297,1312
1/26/20,0,3,0,5,7,0,2,1985,2002
1/27/20,0,4,0,5,7,0,2,2761,2779
1/28/20,0,4,0,5,8,0,2,4533,4552
1/29/20,0,4,0,5,8,0,4,5997,6018
1/30/20,1,7,0,5,8,0,6,7736,7763
1/31/20,5,11,0,5,8,0,6,9720,9755
2/1/20,5,12,0,5,8,0,10,11821,11861
2/2/20,2,15,0,6,9,0,11,14411,14454
2/3/20,3,15,0,6,10,0,11,17238,17283
2/4/20,7,16,0,6,13,0,12,20471,20525
2/5/20,7,21,0,6,17,0,16,24363,24430
2/6/20,7,24,0,6,19,0,18,28060,28134
2/7/20,7,24,0,6,19,0,19,31211,31286
2/8/20,7,24,0,6,19,0,20,34598,34674
2/9/20,7,27,0,6,20,0,20,37251,37331
2/10/20,7,28,0,6,20,0,20,40235,40316
2/11/20,7,28,0,7,20,0,21,42708,42791
2/12/20,7,28,0,7,20,0,23,44730,44815
2/13/20,7,28,0,7,20,0,24,59882,59968
2/14/20,7,28,0,10,22,0,24,63932,64023
2/15/20,7,28,0,10,23,0,24,66576,66668
2/16/20,7,30,0,10,24,0,25,68584,68680
2/17/20,7,30,0,10,24,0,25,70635,70731
2/18/20,7,32,0,10,24,0,27,72528,72628
2/19/20,7,66,0,10,26,0,28,74278,74415
2/20/20,7,82,0,10,31,0,28,74675,74833
2/21/20,7,156,0,10,34,1,30,75568,75806
2/22/20,7,346,0,10,35,1,30,76393,76822
2/23/20,7,556,0,11,40,1,30,77042,77687
2/24/20,7,763,0,12,48,1,30,77262,78123
2/25/20,7,893,0,14,48,1,31,77779,78773
2/26/20,7,1146,0,16,52,1,34,78190,79446
2/27/20,7,1595,1,17,56,1,42,78630,80349
2/28/20,7,2022,1,24,64,4,66,78959,81147
2/29/20,7,2931,1,47,69,4,112,79389,82560
3/1/20,7,3526,1,70,73,6,135,79968,83786
3/2/20,5,4212,2,89,82,8,170,80174,84742
3/3/20,9,4812,2,126,100,10,213,80302,85574
3/4/20,28,5328,2,198,135,15,297,80422,86425
3/5/20,29,5766,2,283,186,24,454,80565,87309
3/6/20,31,6284,3,382,256,34,640,80710,88340
3/7/20,34,6767,8,572,334,45,827,80813,89400
3/8/20,39,7134,13,846,464,51,969,80859,90375
3/9/20,44,7382,19,1136,610,58,1074,80904,91227
3/10/20,50,7513,25,1505,824,66,1421,80924,92328
3/11/20,60,7755,25,2155,1215,71,2016,80955,94252
3/12/20,73,7869,34,3191,1712,88,2773,80980,96720
3/13/20,81,7979,60,4537,2241,127,3764,80991,99780
3/14/20,84,8086,77,6348,2976,168,5228,81021,103988
3/15/20,107,8162,84,8526,3927,234,6531,81048,108619
3/16/20,114,8236,121,10558,5145,286,7511,81077,113048
3/17/20,137,8320,200,12868,7318,323,9548,81117,119831
3/18/20,151,8413,234,16133,9662,400,12581,81151,128725
3/19/20,173,8565,291,20616,12868,504,16181,81237,140435
3/20/20,223,8652,428,25402,17755,620,20242,81300,154622
3/21/20,283,8799,428,31283,23874,771,24299,81416,171153
3/22/20,360,8897,904,37814,31412,903,27656,81498,189444
3/23/20,434,8961,904,43607,40538,988,29921,81601,206954
3/24/20,519,9037,1546,48933,51380,1058,33652,81747,227872
3/25/20,606,9137,1891,57139,62064,1226,38531,81848,252442
3/26/20,649,9241,2201,66866,73458,1446,44212,81961,280034
3/27/20,724,9332,2433,77004,87547,1631,50114,82078,310863
3/28/20,909,9478,2915,87118,106082,1855,56095,82213,346665
3/29/20,979,9583,3417,96214,126291,2117,60815,82341,381757
3/30/20,1071,9661,3903,103314,147102,2308,63892,82447,413698
3/31/20,1251,9786,4256,108407,173398,2474,68011,82545,450128
4/1/20,1637,9887,4579,116417,188658,2819,74070,82631,480698
4/2/20,1965,9976,5717,124343,212367,3130,80329,82724,520551
4/3/20,2301,10062,6836,131408,240796,3512,86879,82802,564596
4/4/20,2902,10156,7910,138318,270669,3859,93069,82875,609758
4/5/20,3374,10237,9056,145140,302417,4251,97410,82930,654815
4/6/20,4067,10284,10278,149812,334935,4501,99946,83005,696828
4/7/20,4421,10331,11130,152959,362000,4760,103606,83072,732279
4/8/20,5274,10384,12056,158359,390606,5391,108795,83157,774022
4/9/20,5865,10423,13717,163682,419818,5906,114071,83249,816731
4/10/20,6412,10450,15927,169170,454050,6487,118980,83305,864781
4/11/20,7447,10480,17857,173782,488864,6970,122335,83369,911104
4/12/20,8356,10512,19638,178223,521581,7542,125219,83482,954553
4/13/20,9152,10537,20727,181298,553671,8006,127086,83597,994074
4/14/20,10363,10564,22169,183677,580865,8485,128684,83696,1028503
4/15/20,11439,10591,23430,186805,605855,9438,131150,83745,1062453
4/16/20,12380,10613,25262,190801,631016,10374,134475,83797,1098718
4/17/20,13387,10635,28320,194503,656283,11359,137894,83824,1136205
4/18/20,14378,10653,30425,197920,687998,12355,140941,84180,1178850
4/19/20,15712,10661,33682,201382,718273,13500,143049,84201,1220460
4/20/20,17265,10674,36599,203564,745984,14315,144426,84237,1257064
4/21/20,18601,10683,38654,205009,772985,15109,146138,84250,1291429
4/22/20,19984,10694,40581,207527,799117,16630,148323,84287,1327143
4/23/20,21393,10702,43079,210256,824410,18101,150810,84302,1363053
4/24/20,23077,10708,45757,213025,855614,19524,152902,84311,1404918
4/25/20,24506,10718,49492,215248,888687,21030,154806,84324,1448811
4/26/20,26496,10728,52995,217534,923639,22764,156077,84338,1494571
4/27/20,27892,10738,58509,218824,956464,23928,156781,84341,1537477
4/28/20,29435,10752,61888,219644,983101,25045,157900,84347,1572112
4/29/20,31332,10761,66501,221297,1007101,26987,159365,84369,1607713
4/30/20,33050,10765,71886,223034,1030861,28948,160796,84373,1643713
5/1/20,35043,10774,78162,224518,1057900,30896,162257,84385,1683935
5/2/20,37336,10780,85380,225957,1089295,32780,163175,84388,1729091
5/3/20,39980,10793,91589,226750,1121321,34335,163795,84393,1772956
5/4/20,42533,10801,96559,227316,1149609,35828,164220,84400,1811266
5/5/20,46433,10804,101147,227768,1176352,37205,164950,84404,1849063
5/6/20,49391,10806,107780,228781,1197862,39847,166042,84406,1884915
5/7/20,52952,10810,114715,229763,1220743,42081,167263,84409,1922736
5/8/20,56342,10822,125218,230747,1246180,44470,168465,84415,1966659
5/9/20,59662,10840,135106,231703,1275507,47001,169443,84416,2013678
5/10/20,62939,10874,145328,232621,1303572,49531,170121,84430,2059416
5/11/20,67152,10909,155939,233112,1329485,51188,170462,84450,2102697
5/12/20,70756,10936,162699,233428,1351126,52740,171147,84451,2137283
5/13/20,74281,10962,168331,234716,1370816,55858,172001,84458,2171423
5/14/20,78003,10991,177589,235450,1394939,58928,172913,84464,2213277
5/15/20,81970,11018,188974,236260,1412394,62158,173721,84469,2250964
5/16/20,85940,11037,202918,237048,1446726,65375,174449,84478,2307971
5/17/20,90927,11050,218223,237848,1473606,69069,174911,84484,2360118
5/18/20,96169,11065,233142,238197,1499380,71339,175227,84494,2409013
5/19/20,101139,11078,241080,238441,1519342,73078,175770,84500,2444428
5/20/20,106750,11110,254220,239075,1542351,77259,176498,84505,2491768
5/21/20,112359,11122,271628,239930,1564031,80969,177330,84507,2541876
5/22/20,118447,11142,291579,240681,1587996,85021,177749,84520,2597135
5/23/20,125101,11165,310087,241462,1613768,89124,178275,84522,2653504
5/24/20,131868,11190,330890,242286,1639722,93256,178612,84525,2712349
5/25/20,138845,11206,347398,242601,1660876,95672,178831,84536,2759965
5/26/20,145380,11225,363211,242863,1682513,97674,179242,84543,2806651
5/27/20,151767,11265,374898,243413,1702025,102462,179859,84544,2850233
5/28/20,158333,11344,391222,244156,1718824,106885,180511,84547,2895822
5/29/20,165799,11402,411821,244778,1738577,111451,181040,84547,2949415
5/30/20,173763,11441,438238,245439,1762736,115761,181485,84565,3013428
5/31/20,182143,11468,465166,246174,1786428,120229,181859,84570,3078037
6/1/20,190535,11503,498440,246512,1810467,123051,182037,84588,3147133
6/2/20,198706,11541,514849,246695,1831725,125250,182173,84597,3195536
6/3/20,207615,11590,526447,247058,1848924,130703,182480,84602,3239419
6/4/20,216919,11629,555383,247537,1869716,135540,182976,84603,3304303
6/5/20,226770,11668,584016,248143,1890683,140613,183504,84614,3370011
6/6/20,236657,11719,614941,248662,1911283,145626,183941,84620,3437449
6/7/20,246628,11776,645771,249314,1935969,150785,184226,84629,3509098
6/8/20,256611,11813,672846,249589,1959669,153934,184390,84634,3573486
6/9/20,266598,11851,691758,249733,1977401,156402,184687,84635,3623065
6/10/20,276583,11901,707412,250081,1995466,162693,185113,84641,3673890
6/11/20,286579,11946,739503,250532,2013999,168566,185631,84652,3741408
6/12/20,297535,12002,772416,250995,2036202,174392,185912,84659,3814113
6/13/20,308993,12050,802828,251380,2059169,179863,186265,84671,3885219
6/14/20,320922,12084,828810,251877,2087540,185607,186564,84729,3958133
6/15/20,332424,12121,850514,252001,2113930,188838,186736,84778,4021342
6/16/20,343091,12155,867624,252089,2134444,191540,186996,84823,4072762
6/17/20,354065,12198,888271,252389,2155086,198230,187515,84867,4132621
6/18/20,366946,12257,923189,252789,2179861,204706,188379,84903,4213030
6/19/20,380532,12306,955377,253153,2205674,210886,189143,84940,4292011
6/20/20,395048,12373,978142,253545,2234294,217032,190133,84970,4365537
6/21/20,410461,12421,1032913,253897,2267475,223194,190702,84997,4476060
6/22/20,425282,12438,1067579,254128,2300799,226930,190925,85018,4563099
6/23/20,440215,12484,1085038,254296,2328040,229540,191369,85070,4626052
6/24/20,456183,12535,1106470,254545,2356792,236554,191910,85098,4700087
6/25/20,473105,12563,1145906,254998,2394656,243171,192416,85119,4801934
6/26/20,490401,12602,1188631,255345,2431836,249540,192987,85148,4906490
6/27/20,508953,12653,1228114,255720,2478968,255882,193561,85172,5019023
6/28/20,528859,12715,1274974,256205,2525483,262500,193886,85190,5139812
6/29/20,548318,12757,1313667,256467,2568871,266279,194087,85204,5245650
6/30/20,566840,12799,1344143,256658,2606384,269344,194502,85227,5335897
7/1/20,585493,12850,1368195,256943,2645037,276907,194960,85232,5425617
7/2/20,604641,12904,1402041,257399,2691627,284136,195443,85263,5533454
7/3/20,625544,12965,1448753,257859,2750905,291832,195915,85278,5669051
7/4/20,648315,13028,1496858,258355,2806278,298932,196342,85287,5803395
7/5/20,673165,13089,1539081,258955,2866559,306053,196636,85306,5938844
7/6/20,697413,13137,1577004,259262,2916056,309813,196780,85320,6054785
7/7/20,719665,13181,1603055,259472,2956054,312916,197103,85345,6146791
7/8/20,742417,13243,1623284,259818,3007093,320799,197495,85366,6249515
7/9/20,767296,13293,1668589,260540,3063171,328726,197946,85399,6384960
7/10/20,793802,13338,1713160,261301,3128255,336179,198370,85445,6529850
7/11/20,820916,13373,1755779,262165,3190416,343238,198795,85487,6670169
7/12/20,849553,13417,1800827,263334,3258722,350459,199072,85522,6820906
7/13/20,878254,13479,1839850,263954,3326018,354386,199203,85568,6960712
7/14/20,906752,13512,1864681,264347,3385630,357664,199532,85623,7077741
7/15/20,936181,13551,1884967,265239,3441738,366591,200000,85677,7193944
7/16/20,968876,13612,1926824,266562,3506509,375054,200541,85697,7343675
7/17/20,1003832,13672,1966748,268157,3578510,383918,201098,85775,7501710
7/18/20,1038716,13711,2012151,269797,3648036,392184,201621,85857,7662073
7/19/20,1077618,13745,2046328,271930,3724845,400234,202064,85937,7822701
7/20/20,1118043,13771,2074860,273490,3792190,404687,202243,86068,7965352
7/21/20,1155191,13816,2098389,274648,3851974,408188,202699,86152,8091057
7/22/20,1192915,13879,2118646,276275,3910503,417321,203223,86226,8218988
7/23/20,1238635,13938,2159654,278627,3973874,425981,203922,86361,8380992
7/24/20,1287945,13979,2227514,280982,4046020,434285,204616,86500,8581841
7/25/20,1336861,14092,2287475,283359,4119465,442382,205426,86660,8775720
7/26/20,1385522,14150,2343366,286204,4192599,450411,205969,86839,8965060
7/27/20,1435453,14175,2394513,287918,4253915,454622,206181,87028,9133805
7/28/20,1483156,14203,2419091,289293,4312190,457692,206710,87245,9269580
7/29/20,1531669,14251,2442375,291341,4365627,466219,207466,87457,9406405
7/30/20,1583792,14269,2483191,294271,4424473,474421,208378,87680,9570475
7/31/20,1638870,14305,2552265,297476,4489214,482095,209242,87956,9771423
8/1/20,1695988,14336,2610102,300965,4555403,489671,210156,88122,9964743
8/2/20,1750723,14366,2662485,304839,4623510,496410,210718,88302,10151353
8/3/20,1803695,14389,2707877,307894,4680026,500244,211023,88460,10313608
8/4/20,1855745,14423,2733677,309736,4731168,502807,211822,88574,10447952
8/5/20,1908254,14456,2750318,312526,4776360,510344,212772,88682,10573712
8/6/20,1964536,14499,2801921,316961,4828086,517737,213884,88804,10746428
8/7/20,2027074,14519,2859073,321286,4883668,524916,215054,88937,10934527
8/8/20,2088611,14562,2912212,326179,4938030,531594,216060,89057,11116305
8/9/20,2153010,14598,2962442,331919,4999870,538224,216771,89149,11305983
8/10/20,2215074,14626,3012412,335444,5051125,541906,217092,89270,11476949
8/11/20,2268675,14660,3035422,338077,5097343,544348,218197,89383,11606105
8/12/20,2329638,14714,3057470,342006,5141037,551619,219390,89444,11745318
8/13/20,2396637,14770,3109630,348196,5199852,558500,220931,89526,11938042
8/14/20,2461190,14873,3164785,354640,5254552,565001,222422,89625,12127088
8/15/20,2526192,15039,3224876,361734,5306238,571457,223798,89695,12319029
8/16/20,2589682,15318,3275520,370148,5362171,577676,224554,89761,12504830
8/17/20,2647663,15515,3317096,374983,5413444,580931,225048,89859,12664539
8/18/20,2702742,15761,3340197,378279,5454723,583271,226597,89926,12791496
8/19/20,2767273,16058,3359570,383280,5496480,590174,228130,89980,12930945
8/20/20,2836925,16346,3407354,391826,5537977,596906,229883,90013,13107230
8/21/20,2905823,16670,3456652,400519,5584587,603205,231503,90053,13289012
8/22/20,2975701,17002,3501975,409571,5630891,609236,233159,90103,13467638
8/23/20,3044940,17399,3532330,420096,5678463,615543,234078,90141,13632990
8/24/20,3106348,17665,3582362,426156,5719779,618706,234643,90182,13795841
8/25/20,3167323,17945,3605783,430446,5756654,621062,236069,90205,13925487
8/26/20,3234474,18265,3622861,436506,5792738,628161,237555,90239,14060799
8/27/20,3310234,18706,3669995,446849,5833065,634858,239173,90271,14243151
8/28/20,3387500,19077,3717156,457179,5879787,641895,240716,90301,14433611
8/29/20,3463972,19400,3761391,467529,5926545,648436,242106,90323,14619702
8/30/20,3542733,19699,3804803,479517,5973327,654773,242940,90351,14808143
8/31/20,3621245,19947,3846153,486409,6014020,657940,243477,90383,14979574
9/1/20,3691166,20182,3862311,491601,6050611,660185,244663,90402,15111121
9/2/20,3769523,20449,3908272,498256,6089414,667229,245986,90422,15289551
9/3/20,3853406,20644,3950931,508775,6128493,674384,247397,90442,15474472
9/4/20,3936747,20842,3997865,519513,6172390,681305,248914,90475,15668051
9/5/20,4023179,21010,4041638,530514,6217621,687605,250409,90498,15862474
9/6/20,4113811,21177,4092832,543728,6268440,693646,251515,90517,16075666
9/7/20,4204613,21296,4123000,551622,6309891,696552,252096,90551,16249621
9/8/20,4280422,21432,4137521,557120,6343573,698650,253509,90573,16382800
9/9/20,4370128,21588,4147794,564177,6368648,705078,254890,90582,16522885
9/10/20,4465863,21743,4162073,576154,6396711,711707,256635,90595,16681481
9/11/20,4562414,21919,4197889,588987,6431735,717772,258224,90623,16869563
9/12/20,4659984,22055,4238446,602043,6470301,723479,259875,90643,17066826
9/13/20,4754356,22176,4282164,616477,6514503,728985,261098,90666,17270425
9/14/20,4846427,22285,4315687,624805,6554526,731800,261860,90695,17448085
9/15/20,4930236,22391,4330455,631211,6587291,733718,263348,90718,17589368
9/16/20,5020359,22504,4345610,639427,6621799,739991,265352,90734,17745776
9/17/20,5118253,22657,4382263,653284,6658533,744363,267546,90753,17937652
9/18/20,5214677,22783,4419083,667340,6702767,746614,269903,90797,18133964
9/19/20,5308014,22893,4455386,681159,6747383,753030,272072,90814,18330751
9/20/20,5400619,22975,4495183,697906,6795252,758644,273464,90840,18534883
9/21/20,5487580,23045,4528240,706239,6837367,761466,274154,90876,18708967
9/22/20,5562663,23106,4544629,712103,6871591,763331,275811,90890,18844124
9/23/20,5646010,23216,4558068,720140,6913243,769654,277626,90908,18998865
9/24/20,5732518,23341,4591604,732964,6962473,775831,279840,90918,19189489
9/25/20,5818570,23455,4624885,745745,7004379,781665,282232,90933,19371864
9/26/20,5903932,23516,4657702,758411,7050437,787073,284567,90951,19556589
9/27/20,5992532,23611,4689613,771963,7100101,792360,286352,90966,19747498
9/28/20,6074702,23661,4717991,779626,7141901,795031,287226,90993,19911131
9/29/20,6145291,23699,4732309,784670,7177163,796871,289060,91018,20040081
9/30/20,6225763,23812,4745464,791723,7216044,803175,291223,91041,20188245
10/1/20,6312584,23889,4777522,803084,7254791,809139,293960,91061,20366030
10/2/20,6394068,23952,4810935,814302,7300396,814697,296886,91082,20546318
10/3/20,6473544,24027,4847092,825397,7347529,819990,299811,91101,20728491
10/4/20,6549373,24091,4880523,837810,7398642,824996,302008,91121,20908564
10/5/20,6623815,24164,4906833,844704,7446319,827454,303163,91146,21067598
10/6/20,6685082,24239,4915289,849846,7481717,829223,305576,91170,21182142
10/7/20,6757131,24353,4927235,858765,7523225,835157,309167,91188,21326221
10/8/20,6835655,24422,4969141,871020,7564741,841113,313662,91212,21510966
10/9/20,6906151,24476,5000694,883475,7618702,846888,318328,91252,21689966
10/10/20,6979423,24548,5028444,897355,7674063,852401,323391,91278,21870903
10/11/20,7053806,24606,5055888,912159,7733036,858067,327020,91305,22055887
10/12/20,7120538,24703,5082637,920899,7786787,861108,329291,91333,22217296
10/13/20,7175880,24805,5094979,927667,7831258,863326,333480,91359,22342754
10/14/20,7239389,24878,5103408,934006,7880777,870153,338847,91387,22482845
10/15/20,7307097,24988,5113628,946423,7930871,877288,346097,91398,22637790
10/16/20,7370468,25035,5140863,962848,7988632,883764,354002,91434,22817046
10/17/20,7432680,25108,5169386,980385,8051543,890230,361981,91459,23002772
10/18/20,7494551,25199,5200300,998704,8120536,896845,367669,91489,23195293
10/19/20,7550273,25275,5224362,1010660,8174874,900199,371348,91506,23348497
10/20/20,7597063,25333,5235344,1018906,8223556,902568,377839,91545,23472154
10/21/20,7651107,25422,5250727,1034629,8285155,910801,387292,91564,23636697
10/22/20,7706946,25543,5273954,1055560,8343975,919195,399703,91587,23816463
10/23/20,7761312,25698,5298772,1078810,8412930,926615,413635,91620,24009392
10/24/20,7814682,25775,5323630,1102651,8487657,933911,427676,91652,24207634
10/25/20,7864811,25836,5353656,1127693,8569914,941146,438777,91674,24413507
10/26/20,7909959,25955,5380635,1143136,8646017,944649,446230,91700,24588281
10/27/20,7946429,26043,5394128,1154397,8711514,947123,458257,91724,24729615
10/28/20,7990322,26146,5409854,1174415,8781324,955534,474200,91771,24903566
10/29/20,8040203,26271,5439641,1198748,8856552,963483,493447,91821,25110166
10/30/20,8088851,26384,5468270,1223379,8940994,970668,513300,91852,25323698
10/31/20,8137119,26511,5494376,1247575,9032117,977541,532707,91893,25539839
11/1/20,8184082,26635,5516658,1272529,9129731,983825,546705,91921,25752086
11/2/20,8229313,26732,5535605,1288582,9222160,986844,557229,91955,25938420
11/3/20,8267623,26807,5545705,1299564,9363540,989016,572485,92015,26156755
11/4/20,8313876,26924,5554206,1315075,9451008,994187,591843,92045,26339164
11/5/20,8364086,27049,5566049,1337167,9549404,1002274,613047,92077,26551153
11/6/20,8411724,27194,5590025,1361358,9663483,1009911,635330,92121,26791146
11/7/20,8462080,27283,5612319,1384954,9786527,1017468,656911,92164,27039706
11/8/20,8507754,27426,5631181,1408516,9920380,1024566,672843,92195,27284861
11/9/20,8553657,27552,5653561,1423105,10049332,1028111,682979,92242,27510539
11/10/20,8591730,27652,5664115,1432949,10160972,1030763,698967,92271,27699419
11/11/20,8636011,27797,5675032,1449511,10285592,1039737,718588,92299,27924567
11/12/20,8683916,27940,5700044,1470129,10431652,1048676,741294,92336,28195987
11/13/20,8728795,28131,5748375,1490163,10585258,1057034,764820,92372,28494948
11/14/20,8773479,28336,5781582,1509361,10747232,1065185,786198,92404,28783777
11/15/20,8814579,28544,5810652,1527807,10924550,1072766,801994,92428,29073320
11/16/20,8845127,28766,5848959,1538401,11088353,1076674,810843,92452,29329575
11/17/20,8874290,28996,5863093,1545077,11227424,1079315,825540,92476,29536211
11/18/20,8912907,29281,5876464,1557917,11380148,1082628,845895,92490,29777730
11/19/20,8958483,29606,5911758,1573822,11547429,1092253,869598,92513,30075462
11/20/20,9004365,29954,5945849,1588648,11718180,1100972,893361,92544,30373873
11/21/20,9050597,30340,5981767,1601849,11907501,1109187,915657,92588,30689486
11/22/20,9095806,30670,6020164,1614508,12100653,1117582,930429,92648,31002460
11/23/20,9139865,30941,6052786,1621750,12274236,1121802,939253,92733,31273366
11/24/20,9177840,31290,6071401,1626369,12425092,1124587,954326,92829,31503734
11/25/20,9222216,31672,6087608,1635533,12584850,1134948,973737,92914,31763478
11/26/20,9266705,32253,6118708,1646498,12760217,1145235,995788,93025,32058429
11/27/20,9309787,32808,6166606,1656526,12954100,1154821,1018553,93113,32386314
11/28/20,9351109,33311,6204220,1666171,13098085,1164421,1038696,93225,32649238
11/29/20,9392919,33761,6238350,1676109,13263741,1174039,1053638,93329,32925886
11/30/20,9431691,34199,6290272,1681608,13407430,1178935,1062423,93465,33180023
12/1/20,9462809,34650,6314740,1685020,13548063,1181948,1075719,93577,33396526
12/2/20,9499413,35161,6335878,1692463,13700308,1192882,1094935,93668,33644708
12/3/20,9534964,35701,6386787,1701979,13893197,1204515,1118139,93797,33969079
12/4/20,9571559,36329,6436650,1710897,14102811,1215981,1142565,93905,34310697
12/5/20,9608211,36906,6487084,1719062,14320279,1227200,1164820,94038,34657600
12/6/20,9644222,37537,6533968,1727501,14544949,1238115,1180546,94160,35000998
12/7/20,9677203,38152,6577177,1732467,14750758,1244113,1190780,94293,35304943
12/8/20,9703770,38739,6603540,1735749,14927535,1247291,1207244,94383,35558251
12/9/20,9735850,39409,6623911,1740992,15110542,1260401,1230041,94500,35835646
12/10/20,9767371,40089,6674999,1745043,15338043,1273408,1257679,94618,36191250
12/11/20,9796769,40778,6728452,1753483,15558831,1285910,1286721,94749,36545693
12/12/20,9826775,41728,6781799,1764262,15767212,1298666,1313975,94849,36889266
12/13/20,9857029,42758,6836227,1775608,16013827,1311165,1334581,94950,37266145
12/14/20,9884100,43476,6880127,1782207,16230077,1318067,1347081,95064,37580199
12/15/20,9906165,44356,6901952,1786455,16411243,1321489,1366154,95167,37832981
12/16/20,9932547,45434,6927145,1796377,16609155,1335870,1393082,95279,38134889
12/17/20,9956557,46448,6970034,1808568,16808696,1349916,1424445,95375,38460039
12/18/20,9979447,47512,7040608,1820342,17049084,1363247,1456399,95491,38852130
12/19/20,10004599,48557,7110434,1831335,17295010,1376047,1486169,95580,39247731
12/20/20,10031223,49654,7162978,1843562,17531092,1388598,1507863,95716,39610686
12/21/20,10055560,50578,7213155,1850497,17733725,1395214,1521761,95816,39916306
12/22/20,10075116,51444,7238600,1854884,17920274,1399013,1542057,95916,40177304
12/23/20,10099066,52534,7263619,1865907,18103442,1413489,1571037,95998,40465092
12/24/20,10123778,53519,7318821,1879345,18302203,1427376,1605006,96074,40806122
12/25/20,10146845,54754,7365517,1893881,18528469,1440199,1626144,96159,41151968
12/26/20,10169118,55885,7425593,1903878,18730222,1450679,1639294,96240,41470909
12/27/20,10187850,56855,7448560,1908702,18889034,1453414,1650836,96324,41691575
12/28/20,10207871,57661,7465806,1915135,19038716,1459347,1660643,96417,41901596
12/29/20,10224303,58705,7484285,1921102,19191628,1463744,1676381,96513,42116661
12/30/20,10244852,59755,7504833,1936232,19369995,1479968,1703950,96592,42396177
12/31/20,10266674,60722,7563551,1955216,19578801,1496067,1735004,96673,42752708
1/1/21,10286709,61750,7619200,1976337,19815842,1510795,1754591,96762,43121986
1/2/21,10305788,62574,7675973,1991942,20045238,1522878,1764861,96829,43466083
1/3/21,10323965,63231,7700578,1999613,20272561,1526292,1774881,96894,43758015
1/4/21,10340469,64251,7716405,2010144,20498962,1533238,1783716,96972,44044157
1/5/21,10356844,64965,7733746,2020106,20703181,1538510,1798022,97061,44312435
1/6/21,10374932,65803,7753752,2042292,20878108,1557063,1825465,97127,44594542
1/7/21,10395278,66672,7810400,2073063,21121530,1575886,1853428,97217,44993474
1/8/21,10413417,67346,7873830,2087685,21379314,1594296,1879531,97306,45392725
1/9/21,10431639,67987,7961673,2114494,21648807,1613060,1904072,97387,45839119
1/10/21,10450284,68644,8013708,2147405,21941643,1631661,1920731,97518,46271594
1/11/21,10466595,69095,8075998,2166727,22197211,1641505,1929206,97652,46643989
1/12/21,10479179,69632,8105790,2180672,22421105,1647168,1942692,97754,46943992
1/13/21,10495147,70193,8131612,2213211,22625359,1668212,1965279,97933,47266946
1/14/21,10512093,70717,8195637,2250622,22843164,1687711,1989380,98117,47647441
1/15/21,10527683,71229,8256536,2289636,23070146,1706359,2009787,98290,48029666
1/16/21,10542841,71809,8324294,2328074,23293346,1724728,2028088,98459,48411639
1/17/21,10557985,72329,8393492,2371089,23532613,1742240,2041517,98625,48809890
1/18/21,10571773,72718,8455059,2396125,23745334,1751679,2048113,98794,49139595
1/19/21,10581837,73104,8488099,2414800,23929210,1757006,2057276,99026,49400358
1/20/21,10595660,73508,8511770,2450616,24080702,1776680,2075736,99191,49663863
1/21/21,10610883,73909,8573864,2493113,24230957,1795723,2095226,99414,49973089
1/22/21,10625428,74254,8638249,2535101,24418727,1813201,2112033,99589,50316582
1/23/21,10639684,74685,8697368,2576009,24606468,1830125,2127062,99767,50651168
1/24/21,10654533,75077,8753920,2618312,24796688,1846604,2138635,99931,50983700
1/25/21,10667736,75514,8816254,2642167,24961122,1855407,2143654,100136,51261990
1/26/21,10676838,75863,8844577,2659519,25105056,1860155,2150402,100291,51472701
1/27/21,10689527,76422,8871393,2692376,25239170,1878354,2165911,100431,51713584
1/28/21,10701193,76919,8933356,2729945,25385655,1895416,2181723,100548,52004755
1/29/21,10720048,77388,8996876,2765834,25544544,1910334,2195086,100641,52310751
1/30/21,10733131,77844,9058687,2799284,25700470,1924362,2207661,100747,52602186
1/31/21,10746183,78198,9118513,2831712,25864787,1936729,2217600,100877,52894599
2/1/21,10757610,78503,9176975,2849948,26001931,1943542,2221808,100974,53131291
2/2/21,10766245,78839,9204731,2861703,26114183,1947255,2227672,101039,53301667
2/3/21,10777284,79306,9229322,2884277,26243054,1951980,2239970,101092,53506285
2/4/21,10790183,79757,9283418,2910380,26364666,1965428,2253391,101143,53748366
2/5/21,10802591,80127,9339420,2934252,26473448,1977301,2264899,101187,53973225
2/6/21,10814304,80517,9396293,2955450,26598513,1988134,2274913,101241,54209365
2/7/21,10826363,80888,9447165,2975683,26723013,1998337,2283297,101272,54436018
2/8/21,10838194,81176,9497795,2986036,26831483,2003680,2286386,101316,54626066
2/9/21,10847304,81479,9524640,2992149,26923220,2006441,2290568,101363,54767164
2/10/21,10858371,81923,9548079,3005984,27005486,2018112,2299667,101408,54919030
2/11/21,10871294,82427,9599565,3021388,27096892,2027434,2309949,101429,55110378
2/12/21,10880603,82830,9659167,3034787,27195713,2035967,2319301,101463,55309831
2/13/21,10892746,83192,9713909,3046691,27294736,2043801,2327844,101496,55504415
2/14/21,10904940,83518,9765455,3058433,27392303,2051523,2333439,101515,55691126
2/15/21,10916589,83861,9809754,3064206,27477008,2055523,2337200,101536,55845677
2/16/21,10925710,84318,9834513,3067793,27543378,2057695,2341593,101561,55956561
2/17/21,10937320,84939,9866710,3076681,27601635,2066037,2350842,101576,56085740
2/18/21,10950201,85560,9921981,3086580,27659015,2073839,2360849,101604,56239629
2/19/21,10963394,86121,9978747,3095230,27722814,2080875,2370085,101624,56398890
2/20/21,10977387,86569,10030626,3103452,27791115,2087856,2378812,101646,56557463
2/21/21,10991651,86985,10081676,3111447,27864572,2094655,2386590,101669,56719245
2/22/21,11005850,87317,10139148,3115477,27930561,2098088,2389634,101700,56867775
2/23/21,11016434,87674,10168174,3118158,27986029,2100138,2394041,101726,56972374
2/24/21,11030176,88113,10195160,3125021,28042429,2108788,2404224,101750,57095661
2/25/21,11046914,88508,10257875,3132423,28112752,2116308,2415526,101778,57272084
2/26/21,11063491,88895,10324463,3138939,28185264,2123185,2425446,101802,57451485
2/27/21,11079979,89310,10390461,3145140,28256918,2129973,2434904,101836,57628521
2/28/21,11096731,89665,10455630,3151637,28330224,2136860,2442565,101878,57805190
3/1/21,11112241,90020,10517232,3154860,28398021,2140370,2446017,101920,57960681
3/2/21,11124527,90364,10551259,3157109,28449978,2142486,2450701,101945,58068369
3/3/21,11139516,90808,10587001,3162516,28501255,2151160,2461669,101968,58195893
3/4/21,11156923,91232,10646926,3168427,28555471,2158117,2472982,101995,58352073
3/5/21,11173761,91630,10718630,3174412,28621239,2164709,2483117,102015,58529513
3/6/21,11192088,92048,10793732,3180055,28686437,2171042,2492774,102036,58710212
3/7/21,11210799,92464,10869227,3185817,28750285,2177054,2501071,102064,58888781
3/8/21,11229398,92810,10938836,3188701,28807765,2180119,2504435,102101,59044165
3/9/21,11244786,93256,11019344,3190761,28851152,2182120,2509287,102125,59192831
3/10/21,11262707,93726,11051665,3195910,28894454,2189212,2520794,102152,59310620
3/11/21,11285561,94191,11122429,3201611,28948178,2195188,2534791,102172,59484121
3/12/21,11308846,94679,11202305,3207155,29009939,2200717,2547957,102203,59673801
3/13/21,11333728,95169,11277717,3212552,29069961,2206089,2560509,102276,59858001
3/14/21,11359048,95628,11363380,3218412,29133998,2211357,2570980,102333,60055136
3/15/21,11385339,96007,11439558,3221256,29186166,2214029,2575817,102363,60220535
3/16/21,11409831,96370,11483370,3223248,29233374,2215591,2582665,102411,60346860
3/17/21,11438734,96839,11519609,3228869,29277037,2217740,2598463,102433,60479724
3/18/21,11474605,97284,11603535,3235008,29328939,2224524,2616830,102450,60683175
3/19/21,11514331,97747,11693838,3240891,29390263,2229838,2633570,102479,60902957
3/20/21,11555284,98194,11780820,3247324,29452895,2234879,2649272,102502,61121170
3/21/21,11599130,98650,11871390,3252047,29514899,2239657,2662501,102523,61340797
3/22/21,11646081,99065,11950459,3255004,29572984,2242098,2668461,102539,61536691
3/23/21,11686796,99411,11998233,3257322,29618111,2243657,2677371,102566,61683467
3/24/21,11734058,99839,12047526,3263515,29666469,2249603,2696831,102589,61860430
3/25/21,11787534,100269,12130019,3270956,29724366,2254826,2719492,102612,62090074
3/26/21,11846652,100758,12220011,3277939,29792487,2259497,2741399,102635,62341378
3/27/21,11908910,101263,12320169,3285320,29858062,2264116,2761442,102659,62601941
3/28/21,11971624,101745,12404414,3293036,29932989,2268318,2777226,102680,62852032
3/29/21,12039644,102127,12490362,3297185,29995800,2270582,2784814,102698,63083212
3/30/21,12095855,102574,12534688,3300164,30048797,2271911,2795808,102715,63252512
3/31/21,12149335,103080,12573615,3307608,30107066,2277228,2816202,102734,63436868
4/1/21,12221665,103631,12658109,3315885,30168483,2281688,2840209,102762,63692432
4/2/21,12303131,104188,12748747,3324950,30239014,2285736,2861665,102790,63970221
4/3/21,12392260,104731,12839844,3330694,30312435,2287830,2877163,102838,64247795
4/4/21,12485509,105274,12910082,3334583,30382848,2289536,2887796,102867,64498495
4/5/21,12589067,105747,12953597,3339203,30446318,2291153,2894950,102908,64722943
4/6/21,12686049,106225,12984956,3343497,30491782,2292587,2901992,102949,64910037
4/7/21,12801785,106893,13013601,3351252,30548550,2298146,2913513,102970,65136710
4/8/21,12928574,107593,13100580,3362201,30612289,2302803,2937252,103003,65454295
4/9/21,13060542,108263,13193205,3372890,30687275,2307227,2963027,103034,65795463
4/10/21,13205926,108940,13279857,3383325,30762298,2311480,2986328,103066,66141220
4/11/21,13358805,109554,13373174,3393929,30838865,2315544,3004382,103083,66497336
4/12/21,13527717,110141,13445006,3399620,30906549,2317776,3013233,103113,66823155
4/13/21,13689453,110683,13482023,3403595,30959854,2318985,3025356,103136,67093085
4/14/21,13873825,111414,13517808,3412660,31020919,2324089,3052090,103165,67415970
4/15/21,14074564,112112,13599994,3422894,31092373,2328348,3080651,103185,67814121
4/16/21,14291917,112785,13673507,3433285,31163190,2332205,3105736,103203,68215828
4/17/21,14526609,113443,13746681,3443086,31234822,2335993,3128824,103237,68632695
4/18/21,14788109,114114,13832455,3453209,31305951,2339327,3146516,103273,69082954
4/19/21,15061919,114646,13900091,3458587,31383083,2341017,3155325,103315,69517983
4/20/21,15321089,115195,13943071,3462546,31432088,2342118,3167631,103340,69887078
4/21/21,15616130,115926,13973695,3471325,31467581,2346469,3195614,103371,70290111
4/22/21,15930965,116661,14043076,3482025,31524905,2350138,3224995,103382,70776147
4/23/21,16263695,117458,14122795,3491837,31588043,2353778,3250464,103419,71291489
4/24/21,16610481,118235,14167973,3501635,31649875,2357065,3273440,103441,71782145
4/25/21,16960172,118879,14237078,3511632,31711962,2360256,3291472,103464,72294915
4/26/21,17313163,119378,14308215,3516689,31763581,2362003,3300139,103484,72786652
4/27/21,17636307,119890,14340787,3520557,31804246,2363075,3312354,103503,73200719
4/28/21,17997267,120659,14369423,3529460,31834811,2367070,3337628,103529,73659847
4/29/21,18376524,121338,14441563,3539232,31885051,2370532,3362646,103562,74200448
4/30/21,18762976,121999,14521289,3548525,31939592,2373716,3384090,103595,74755782
5/1/21,19164969,122626,14590678,3557426,31995368,2376697,3403250,103622,75314636
5/2/21,19557457,123232,14659011,3566462,32050411,2379398,3418319,103649,75857939
5/3/21,19925604,123720,14725975,3570392,32098610,2380400,3424975,103667,76353343
5/4/21,20282833,124261,14754910,3573518,32135050,2381355,3434103,103694,76789724
5/5/21,20665148,124937,14779529,3579552,32168099,2384795,3455091,103713,77260864
5/6/21,21077410,125511,14856888,3587118,32210699,2387701,3475949,103731,77825007
5/7/21,21491598,126036,14930183,3595040,32255343,2390290,3493120,103759,78385369
5/8/21,21892676,126737,15003563,3602018,32298079,2393068,3508597,103773,78928511
5/9/21,22296414,127301,15082449,3609547,32342629,2395571,3520637,103795,79478343
5/10/21,22662575,127764,15145879,3612997,32379438,2396851,3525955,103808,79955267
5/11/21,22992517,128274,15184790,3615436,32406774,2397633,3533352,103841,80362617
5/12/21,23340938,128908,15209990,3621459,32431379,2399365,3550107,103869,80786015
5/13/21,23703665,129623,15282705,3627454,32464427,2402564,3566594,103901,81280933
5/14/21,24046809,130370,15359397,3633392,32500237,2405198,3576263,103936,81755602
5/15/21,24372907,131051,15433989,3639082,32540629,2407570,3583905,103985,82213118
5/16/21,24684077,131661,15519525,3645059,32575923,2410053,3592504,104191,82662993
5/17/21,24965463,132280,15586534,3647929,32605398,2411265,3596780,104425,83050074
5/18/21,25228996,132808,15627475,3650145,32626757,2412038,3602030,104782,83385031
5/19/21,25496330,133462,15657391,3655301,32646297,2414933,3614356,105040,83723110
5/20/21,25772440,134108,15732836,3661280,32674063,2417514,3625668,105326,84123235
5/21/21,26031991,134669,15812055,3666696,32701679,2420004,3634100,105645,84506839
5/22/21,26289290,135335,15894094,3672155,32729467,2422418,3641681,105971,84890411
5/23/21,26530132,135920,15970949,3677802,32757429,2424806,3647504,106713,85251255
5/24/21,26752447,136458,16047439,3680513,32779449,2425956,3649506,107187,85578955
5/25/21,26948874,136974,16083258,3682502,32795320,2426758,3651307,107798,85832791
5/26/21,27157795,137679,16120756,3687053,32810651,2429713,3654979,108356,86106982
5/27/21,27369093,138308,16194209,3692495,32834868,2432430,3662132,109010,86432545
5/28/21,27555457,138895,16274695,3697775,32858387,2435064,3668953,109688,86738914
5/29/21,27729247,139428,16342162,3703121,32880433,2437622,3674111,110260,87016384
5/30/21,27894800,139908,16391930,3708462,32905173,2440122,3677799,110764,87268958
5/31/21,28047534,140338,16471600,3711383,32920748,2441261,3679405,111146,87523415
6/1/21,28175044,140797,16515120,3713338,32933047,2442193,3681845,111523,87712907
6/2/21,28307832,141474,16545554,3718171,32942367,2445274,3686952,111884,87899508
6/3/21,28441986,142155,16624480,3723309,32951421,2448082,3691439,112457,88135329
6/4/21,28574350,142850,16720081,3728437,32967568,2450896,3694377,113066,88391625
6/5/21,28694879,143594,16803472,3732901,32985886,2453552,3696652,113564,88624500
6/6/21,28809339,144150,16841408,3737484,33004514,2456319,3698958,114105,88806277
6/7/21,28909975,144635,16907425,3739927,33019130,2457669,3700091,114667,88993519
6/8/21,28996473,145089,16947062,3741642,33030150,2458512,3701807,114691,89135426
6/9/21,29089069,145691,16984218,3745815,33040141,2462195,3705345,114928,89287402
6/10/21,29183121,146301,17037129,3749970,33054465,2465785,3708211,115217,89460199
6/11/21,29274823,146857,17122877,3754081,33074114,2469174,3710493,115498,89667917
6/12/21,29359155,147422,17210969,3758207,33090022,2472482,3712335,115815,89866407
6/13/21,29439989,147874,17296118,3762212,33104097,2475771,3713646,116103,90055810
6/14/21,29510410,148273,17374818,3764426,33116387,2477481,3714161,116301,90222257
6/15/21,29570881,148646,17412766,3765980,33125102,2478575,3715094,116507,90333551
6/16/21,29633105,149191,17452612,3769600,33133432,2482792,3716797,116663,90454192
6/17/21,29700313,149731,17533221,3773669,33146202,2486668,3718240,116853,90624897
6/18/21,29762793,150238,17628588,3777648,33159311,2490600,3719398,117050,90805626
6/19/21,29823546,150720,17702630,3781641,33172727,2494570,3720429,117269,90963532
6/20/21,29881965,151149,17801462,3785654,33184642,2498544,3721164,117421,91142001
6/21/21,29935221,151506,17883750,3787921,33196965,2500606,3721439,117548,91294956
6/22/21,29977861,151900,17927928,3789590,33206009,2501878,3722047,117649,91394862
6/23/21,30028709,152545,17966831,3793456,33214702,2507191,3723111,117758,91504303
6/24/21,30082778,153155,18054653,3797881,33228081,2512371,3724016,117879,91670814
6/25/21,30134445,153789,18169881,3802909,33241893,2517714,3724845,118040,91863516
6/26/21,30183143,154457,18243483,3806802,33257417,2523058,3725584,118145,92012089
6/27/21,30233183,155071,18322760,3812494,33272460,2528282,3726069,118241,92168560
6/28/21,30279331,155572,18386894,3816250,33285641,2531031,3726293,118358,92299370
6/29/21,30316897,156167,18420598,3819373,33296241,2532740,3726818,118439,92387273
6/30/21,30362848,156961,18448402,3827507,33306834,2539702,3727716,118503,92488473
7/1/21,30411634,157722,18513305,3838239,33322481,2546136,3728583,118572,92636672
7/2/21,30458251,158548,18557141,3851351,33334029,2552400,3729293,118644,92759657
7/3/21,30502362,159342,18622304,3865417,33352648,2558927,3729963,118736,92909699
7/4/21,30545433,160084,18687469,3880394,33369519,2565697,3730472,118832,93057900
7/5/21,30585229,160795,18742025,3890688,33382667,2569162,3730681,118896,93180143
7/6/21,30619932,161541,18769808,3898330,33393037,2571425,3731238,118949,93264260
7/7/21,30663665,162753,18792511,3915262,33402290,2580729,3732302,119036,93368548
7/8/21,30709557,164028,18855015,3935776,33422338,2590046,3733263,119094,93529117
7/9/21,30752950,165344,18909037,3958867,33444999,2600146,3734220,119141,93684704
7/10/21,30795716,166722,18962762,3981675,33628709,2610261,3735168,119204,94000217
7/11/21,30837222,168046,19020499,4006254,33656357,2620789,3735958,119262,94164387
7/12/21,30874376,169146,19069003,4021344,33677089,2626111,3736269,119321,94292659
7/13/21,30907282,170296,19089940,4033652,33693698,2629634,3737070,119374,94380946
7/14/21,30946074,171911,19106971,4059503,33722920,2643595,3738834,119427,94509235
7/15/21,30987880,173510,19151993,4087970,33757951,2657660,3740462,119485,94676911
7/16/21,31026829,175046,19209729,4117900,33796324,2671599,3741982,119539,94858948
7/17/21,31064908,176500,19262518,4147490,33836914,2685190,3743601,119602,95036723
7/18/21,31106065,177951,19308109,4177237,33879188,2699286,3744881,119647,95212364
7/19/21,31144229,179203,19342448,4195808,33911314,2706194,3745379,119698,95344273
7/20/21,31174322,180481,19376574,4210314,33939494,2710877,3746808,119784,95458654
7/21/21,31216337,182261,19391845,4240168,33984838,2729083,3749147,119837,95613516
7/22/21,31257720,184103,19419437,4272042,34035856,2747442,3751444,119918,95787962
7/23/21,31293062,185733,19473954,4303949,34097104,2765384,3753667,120000,95992853
7/24/21,31332159,187362,19523711,4335055,34168904,2784256,3755786,120061,96207294
7/25/21,31371901,188848,19632443,4365282,34238594,2802293,3757379,120120,96476860
7/26/21,31411262,190166,19670534,4383493,34292247,2811019,3758018,120213,96636952
7/27/21,31440951,191531,19688663,4396200,34335483,2817400,3759681,120295,96750204
7/28/21,31484605,193425,19707662,4422002,34406815,2840182,3762781,120399,96937871
7/29/21,31528114,195096,19749073,4450963,34492889,2862356,3765626,120469,97164586
7/30/21,31572344,196806,19797086,4478068,34582067,2883059,3768260,120553,97398243
7/31/21,31613993,198345,19839369,4503743,34681450,2904465,3770789,120635,97632789
8/1/21,31655824,199783,19880273,4529562,34786084,2924589,3772753,120722,97869590
8/2/21,31695958,201001,19917855,4544391,34866618,2933966,3773536,120837,98054162
8/3/21,31726507,202201,19938358,4554017,34927895,2941299,3775658,120944,98186879
8/4/21,31769132,203926,19953501,4573882,35030279,2964913,3779415,121067,98396115
8/5/21,31812114,205701,19985817,4595539,35140876,2987899,3782959,121175,98632080
8/6/21,31856757,207405,20026533,4616171,35267732,3009644,3786494,121316,98892052
8/7/21,31895385,209228,20066587,4635807,35395655,3031623,3790030,121437,99145752
8/8/21,31934455,210956,20108746,4655013,35529508,3052872,3792823,121550,99405923
8/9/21,31969954,212447,20151779,4666031,35649505,3062960,3793964,121684,99628324
8/10/21,31998158,213983,20165672,4673303,35746266,3070533,3796888,121837,99786640
8/11/21,32036511,216205,20177757,4688450,35839464,3096136,3802450,121960,99978933
8/12/21,32077706,218192,20212642,4705721,35975281,3120879,3808098,122058,100240577
8/13/21,32117826,220183,20245085,4721568,36118959,3144029,3813540,122168,100503358
8/14/21,32156493,222111,20285067,4736476,36270090,3166350,3819326,122255,100778168
8/15/21,32192576,223925,20319000,4750413,36416421,3188008,3823963,122317,101036623
8/16/21,32225513,225481,20350142,4758481,36555965,3197530,3826035,122378,101261525
8/17/21,32250679,226852,20364099,4764060,36666708,3204317,3830560,122433,101429708
8/18/21,32285857,228656,20378570,4773702,36775860,3228799,3839477,122482,101633403
8/19/21,32322258,230807,20416183,4785749,36926595,3250803,3848237,122542,101903174
8/20/21,32358829,232859,20457897,4798396,37095037,3271764,3856925,122586,102194293
8/21/21,32393286,234738,20494212,4810175,37269499,3290827,3865762,122617,102481116
8/22/21,32424234,236364,20528099,4821961,37436857,3308873,3872586,122662,102751636
8/23/21,32449306,237778,20556487,4828478,37581116,3316543,3875686,122698,102968092
8/24/21,32474773,239287,20570891,4832588,37708041,3322467,3882270,122744,103153061
8/25/21,32512366,241435,20583994,4842437,37824248,3343771,3895171,122777,103366199
8/26/21,32558530,243317,20614866,4852325,37987006,3362549,3907891,122809,103649293
8/27/21,32603188,245153,20645537,4861426,38164096,3379842,3919518,122852,103941612
8/28/21,32649947,246946,20676561,4869629,38350406,3396114,3929929,122897,104242429
8/29/21,32695030,248564,20703906,4877766,38532582,3411838,3938337,122942,104530965
8/30/21,32737939,250049,20728605,4881804,38685386,3418896,3942079,122995,104767753
8/31/21,32768880,251420,20741815,4884499,38803814,3423712,3949167,123043,104946350
9/1/21,32810845,253440,20752281,4890779,38936846,3441487,3963749,123068,105172495
9/2/21,32857937,255401,20776870,4897931,39113575,3457129,3978486,123103,105460432
9/3/21,32903289,257110,20804215,4903900,39312035,3471890,3991214,123131,105766784
9/4/21,32945907,258913,20830495,4909179,39493639,3485833,4003288,123169,106050423
9/5/21,32988673,260403,20856060,4914101,39676725,3499142,4012774,123199,106331077
9/6/21,33027621,261777,20877864,4916826,39820889,3505511,4016823,123231,106550542
9/7/21,33058843,263373,20890779,4918734,39946336,3509713,4023839,123285,106734902
9/8/21,33096718,265421,20899933,4922972,40055982,3525706,4038961,123322,106929015
9/9/21,33139981,267470,20913578,4927694,40173204,3539085,4053119,123361,107137492
9/10/21,33174954,269362,20928008,4931417,40343874,3551293,4065508,123386,107387802
9/11/21,33208330,271227,20958899,4935135,40528139,3563437,4076656,123423,107665246
9/12/21,33236921,272982,20974850,4938919,40699768,3575298,4085207,123478,107907423
9/13/21,33264175,274413,20989164,4940649,40855031,3580532,4088489,123544,108115997
9/14/21,33289579,275909,20999779,4941929,40971372,3584279,4095374,123642,108281863
9/15/21,33316755,277987,21006424,4945297,41083696,3598134,4108770,123722,108460785
9/16/21,33347325,279930,21019830,4948720,41246359,3609893,4120991,123808,108696856
9/17/21,33381728,281938,21034610,4951623,41409712,3617626,4131266,123904,108932407
9/18/21,33417390,284022,21069017,4954525,41577221,3621464,4140154,123961,109187754
9/19/21,33448163,285931,21080219,4957493,41735208,3633223,4147191,124038,109411466
9/20/21,33478419,287534,21230325,4958888,41860837,3637944,4149970,124102,109728019
9/21/21,33504534,289263,21239783,4959790,41958452,3641186,4155379,124185,109872572
9/22/21,33531498,290983,21247667,4962191,42050775,3653944,4166640,124232,110027930
9/23/21,33563421,292698,21247094,4964921,42186017,3664244,4177099,124283,110219777
9/24/21,33594803,295132,21283567,4967427,42318791,3674196,4186185,124348,110444449
9/25/21,33624419,298401,21308178,4969736,42456181,3683067,4194594,124401,110658977
9/26/21,33652745,301170,21327616,4972200,42589473,3691885,4200945,124444,110860478
9/27/21,33678786,303553,21343304,4973434,42688148,3695678,4203591,124495,111010989
9/28/21,33697581,305840,21351972,4974256,42765798,3698423,4209361,124538,111127769
9/29/21,33716451,308725,21366395,4976726,42867466,3708749,4222010,124591,111291113
9/30/21,33739980,311287,21381790,4978955,42983473,3716636,4233392,124629,111470142
10/1/21,33766707,313772,21399546,4981002,43100504,3723999,4242893,124673,111653096
10/2/21,33791061,316019,21427073,4982854,43224045,3730476,4251281,124729,111847538
10/3/21,33813903,318104,21445651,4984723,43345669,3736626,4257435,124772,112026883
10/4/21,33834702,319777,21459117,4985706,43429657,3739440,4260083,124805,112153287
10/5/21,33853048,321351,21468121,4986397,43498193,3741579,4265753,124843,112259285
10/6/21,33871881,323377,21478546,4988273,43584109,3749430,4277969,124884,112398469
10/7/21,33894312,325800,21499074,4990078,43688410,3755977,4289080,124920,112567651
10/8/21,33915569,327976,21516967,4991831,43805619,3762079,4299220,124954,112744215
10/9/21,33935309,329925,21532558,4993497,43918681,3767560,4308442,124987,112910959
10/10/21,33953475,331519,21550730,4995316,44026862,3772783,4315458,125023,113071166
10/11/21,33971607,332816,21567181,4996210,44099114,3775201,4318094,125055,113185278
10/12/21,33985920,334158,21575820,4996738,44159209,3777235,4324354,125085,113278519
10/13/21,34001743,335739,21582738,4998716,44233349,3784000,4336999,125115,113398399
10/14/21,34020730,337677,21590097,4999544,44323315,3789415,4349057,125143,113534978
10/15/21,34037592,339361,21597949,5001417,44419965,3794290,4360398,125162,113676134
10/16/21,34053573,340978,21612237,5003453,44516660,3799150,4371549,125189,113822789
10/17/21,34067719,342395,21627476,5005469,44608072,3803836,4380039,125226,113960232
10/18/21,34081315,343445,21638726,5006583,44672848,3805706,4383447,125254,114057324
10/19/21,34094373,344517,21644464,5007356,44722204,3807110,4391589,125284,114136897
10/20/21,34108996,346088,21651910,5009481,44791330,3812678,4410755,125322,114256560
10/21/21,34127450,347529,21664879,5011580,44872146,3817216,4428735,125351,114394886
10/22/21,34143236,348969,21680488,5013683,44948643,3821482,4446030,125402,114527933
10/23/21,34159562,350476,21697341,5015670,45036066,3825601,4462702,125462,114672880
10/24/21,34175468,351899,21711843,5017774,45117870,3829581,4475996,125518,114805949
10/25/21,34189774,353089,21723559,5018910,45154847,3831286,4481175,125565,114878205
10/26/21,34202202,354353,21729763,5019755,45182894,3832582,4493048,125620,114940217
10/27/21,34215653,356301,21735560,5022015,45266853,3837833,4519426,125686,115079327
10/28/21,34231809,358412,21748984,5024126,45368957,3842026,4546724,125738,115246776
10/29/21,34246157,360536,21766168,5026251,45453021,3845873,4571081,125810,115394897
10/30/21,34260470,362639,21781436,5028422,45556297,3849525,4593654,125898,115558341
10/31/21,34273300,364700,21793401,5030862,45644526,3853010,4610732,125979,115696510
11/1/21,34285814,366385,21804094,5032231,45679502,3854295,4618187,126078,115766586
11/2/21,34296237,367973,21810855,5033183,45704846,3855261,4629673,126155,115824183
11/3/21,34308140,370638,21814693,5034193,45822484,3858729,4654071,126270,115989218
11/4/21,34321025,373120,21821124,5037069,45897254,3861291,4690212,126384,116127479
11/5/21,34333754,375464,21835785,5040005,45975994,3865166,4726679,126471,116279318
11/6/21,34344683,377711,21849137,5043003,46064799,3868681,4760426,126534,116434974
11/7/21,34355536,379934,21862458,5046193,46154675,3871913,4784195,126616,116581520
11/8/21,34366987,381692,21874324,5048028,46190849,3873316,4796066,126710,116657972
11/9/21,34377113,383406,21880439,5049241,46222365,3874347,4820349,126775,116734035
11/10/21,34388579,385831,21886077,5052687,46338792,3878558,4867541,126836,116924901
11/11/21,34401670,388351,21897025,5056511,46421575,3882126,4918392,126908,117092558
11/12/21,34414186,390719,21909298,5060402,46515542,3885470,4968139,127018,117270774
11/13/21,34426036,393135,21924598,5064740,46589100,3888793,5014218,127104,117427724
11/14/21,34437307,395460,21939196,5069646,46711886,3891901,5048191,127199,117620786
11/15/21,34447536,397466,21953838,5072546,46781206,3893122,5067230,127260,117740204
11/16/21,34456401,399591,21957967,5074688,46814799,3893990,5101822,127297,117826555
11/17/21,34466598,402773,21960766,5080284,46948266,3895371,5164813,127331,118046202
11/18/21,34478517,406065,21965684,5086619,47046490,3899308,5228005,127374,118238062
11/19/21,34489623,409099,21977661,5093089,47151637,3902912,5289241,127405,118440667
11/20/21,34499925,412305,21989962,5099940,47275347,3906148,5351780,127439,118662846
11/21/21,34510413,415425,22003317,5107686,47389035,3909126,5394117,127463,118856582
11/22/21,34518901,418251,22012150,5112173,47435191,3910420,5418898,127512,118953496
11/23/21,34526480,420949,22017276,5115342,47473927,3911402,5465532,127537,119058445
11/24/21,34535763,425064,22019870,5123483,47619248,3915792,5540074,127572,119306866
11/25/21,34544882,429000,22030182,5132603,47720238,3919318,5615810,127602,119519635
11/26/21,34555431,432901,22043112,5142235,47826986,3922554,5687698,127631,119738548
11/27/21,34563749,436968,22055238,5152144,47899207,3925689,5751775,127672,119912442
11/28/21,34572523,440891,22067630,5163205,47980833,3928474,5796727,127710,120077993
11/29/21,34580832,444198,22076863,5169982,48032626,3929626,5822255,127764,120184146
11/30/21,34587822,447227,22080906,5174519,48089148,3930631,5866626,127814,120304693
12/1/21,34596776,452346,22084749,5186065,48183394,3934547,5940222,127938,120506037
12/2/21,34606541,457611,22094459,5199370,48304503,3937737,6014229,128022,120742472
12/3/21,34615757,462554,22105872,5213721,48437657,3940782,6082281,128141,120986765
12/4/21,34624360,467906,22118782,5229292,48581621,3943944,6144816,128245,121238966
12/5/21,34633255,473033,22129409,5245458,48733204,3946722,6187320,128319,121476720
12/6/21,34641561,477356,22138247,5256548,48800615,3947783,6210384,128393,121600887
12/7/21,34648383,482309,22143091,5264222,48855927,3948661,6252905,128502,121724000
12/8/21,34656822,489482,22147476,5272251,49039592,3952411,6322234,128602,122008870
12/9/21,34666241,496584,22157726,5290519,49165740,3955667,6389440,128690,122250607
12/10/21,34674744,503606,22167781,5302563,49295656,3958600,6447142,128777,122478869
12/11/21,34682736,510582,22177059,5323822,49432811,3961414,6498292,128884,122715600
12/12/21,34690510,517271,22184824,5350055,49567011,3964203,6532954,128970,122935798
12/13/21,34697860,523085,22188179,5366795,49630946,3965127,6548511,129082,123049585
12/14/21,34703644,528645,22189867,5379781,49689042,3966033,6580123,129165,123166300
12/15/21,34710628,536495,22191949,5407098,49875694,3969355,6640354,129247,123460820
12/16/21,34718602,544116,22195775,5439568,50001813,3972190,6692785,129332,123694181
12/17/21,34726049,551551,22201221,5476728,50148777,3975017,6740070,129430,123948843
12/18/21,34733194,558862,22204941,5515729,50311189,3977785,6781350,129577,124212627
12/19/21,34740275,565096,22209020,5560295,50471890,3980328,6809868,129678,124466450
12/20/21,34746838,570413,22212343,5587169,50559423,3981484,6822101,129794,124609565
12/21/21,34752164,575609,22213762,5609661,50661585,3982471,6849059,129893,124774204
12/22/21,34758481,583059,22215856,5665008,50924744,3986288,6897305,129988,125160729
12/23/21,34765976,589976,22219477,5739761,51129415,3989936,6938237,130109,125502887
12/24/21,34772626,596202,22222928,5826464,51367464,3993876,6973216,130211,125882987
12/25/21,34779815,602044,22226573,5923818,51648377,3998009,6995109,130376,126304121
12/26/21,34786802,607463,22230737,5999506,51889605,4001326,7005535,130625,126651599
12/27/21,34793333,611667,22230737,6046817,52005254,4002440,7015953,130858,126837059
12/28/21,34799691,615529,22239436,6099762,52216301,4004452,7040445,131093,127146709
12/29/21,34808886,620930,22246276,6216654,52679512,4012711,7083780,131315,127800064
12/30/21,34822040,625963,22254706,6355367,53073298,4022540,7125452,131548,128410914
12/31/21,34838804,630835,22263834,6505901,53548357,4034165,7166915,131780,129120591
1/1/22,34861579,635250,22277239,6654145,54136839,4046941,7195863,132071,129939927
1/2/22,34889132,639078,22287521,6759952,54604268,4058236,7210093,132301,130580581
1/3/22,34922882,642202,22291507,6819421,54905775,4061975,7224673,132508,131000943
1/4/22,34960261,645225,22293228,6891140,55296448,4067814,7260618,132737,131547471
1/5/22,35018358,649666,22305078,7038409,56199397,4091893,7325116,132901,132760818
1/6/22,35109286,653791,22323837,7206026,56926931,4123942,7389631,133154,133866598
1/7/22,35226386,657505,22351104,7369247,57635379,4162571,7445944,133404,134981540
1/8/22,35368372,661015,22386930,7445563,58435892,4204840,7501906,133656,136138174
1/9/22,35528004,664383,22450222,7595884,59296172,4251149,7538960,133902,137458676
1/10/22,35707727,667386,22499525,7687625,59744317,4273510,7562715,134151,138276956
1/11/22,35875790,670480,22523907,7780635,60230773,4292360,7616455,134399,139124799
1/12/22,36070510,674863,22558695,7956724,61486705,4360943,7702575,134711,140945726
1/13/22,36317927,679024,22629460,8128620,62293253,4432489,7791010,135019,142406802
1/14/22,36582129,683566,22716091,8289449,63148178,4507631,7875133,135299,143937476
1/15/22,36850962,687980,22814917,8439333,64038465,4581907,7955928,135540,145505032
1/16/22,37122164,692173,22927203,8573794,64936234,4654913,8013077,135742,147055300
1/17/22,37380253,696030,22975723,8659538,65402472,4686100,8048706,136027,147984849
1/18/22,37618271,700097,23000657,8735237,65821002,4709776,8131519,136270,148852829
1/19/22,37901241,705900,23074791,8891334,66782681,4790189,8258282,136441,150540859
1/20/22,38218773,712500,23211894,9039995,67640969,4864824,8398522,136576,152224053
1/21/22,38566027,719269,23416748,9181951,68423616,4935061,8543198,136700,153922570
1/22/22,38903731,726272,23585243,9314498,69201936,5000104,8687237,136854,155555875
1/23/22,39237264,733900,23751782,9441904,69974608,5057504,8783435,137064,157117461
1/24/22,39543328,741408,23909175,9514684,70303587,5082571,8845304,137350,158077407
1/25/22,39799202,749971,24044255,9581104,70618603,5101453,8984552,137582,159016722
1/26/22,40085116,762979,24124595,9712298,71627421,5162758,9178072,137757,160790996
1/27/22,40371500,777486,24311317,9830816,72122328,5213370,9372657,138018,162137492
1/28/22,40622709,793582,24535884,9940801,72667994,5259188,9571570,138313,163530041
1/29/22,40858241,811105,24764838,10034630,73239489,5300092,9759249,138551,164906195
1/30/22,41092522,828624,25034806,10119262,73761786,5336091,9883622,138799,166195512
1/31/22,41302440,845699,25214622,10166269,73983963,5352591,9958165,138992,166962741
2/1/22,41469499,864040,25348797,10206156,74142190,5364759,10116969,139205,167651615
2/2/22,41630885,884307,25426744,10286815,74715147,5401877,10347725,139457,168832957
2/3/22,41803318,907213,25620209,10358963,75012059,5430857,10587254,139664,169859537
2/4/22,41952712,934650,25793112,10425427,75315885,5457236,10824699,139891,170843612
2/5/22,42080664,970997,26091520,10483733,75665274,5480254,11034673,140120,171947235
2/6/22,42188138,1009677,26275831,10537287,75946200,5500024,11168115,140586,172765858
2/7/22,42272014,1044962,26473273,10565264,76050972,5508666,11250968,141049,173307168
2/8/22,42339611,1081672,26533010,10589009,76147492,5515100,11429309,141816,173777019
2/9/22,42410976,1131239,26599593,10642083,76451846,5524612,11680457,142599,174583405
2/10/22,42478060,1185361,26776620,10688584,76649700,5544272,11928081,143843,175394521
2/11/22,42536137,1239287,26955434,10731478,76845955,5559019,12158049,145013,176170372
2/12/22,42586544,1294199,27119500,10768897,77011205,5572505,12364552,146516,176863918
2/13/22,42631421,1350627,27285509,10801784,77166163,5584746,12486917,148157,177455324
2/14/22,42665534,1405244,27425743,10818392,77234028,5590490,12561034,149640,177850105
2/15/22,42692943,1462408,27479963,10832736,77281919,5595252,12719537,151845,178216603
2/16/22,42723558,1552843,27538503,10865413,77455236,5608382,12948575,153610,178846120
2/17/22,42754315,1645975,27659052,10895354,77563365,5618554,13178790,158051,179473456
2/18/22,42780235,1755798,27806786,10922523,77669087,5628164,13392137,164322,180119052
2/19/22,42802505,1858008,27937835,10946591,77769228,5637326,13570726,168155,180690374
2/20/22,42822473,1962822,28058862,10969161,77872956,5645340,13690276,174486,181196376
2/21/22,42838524,2058161,28167587,10980691,77913764,5648873,13754522,180767,181542889
2/22/22,42851929,2157730,28208212,10990766,77944881,5651944,13894252,188487,181888201
2/23/22,42867031,2329172,28245551,11014420,77992543,5659973,14112931,194947,182416568
2/24/22,42881179,2499187,28351327,11036399,78107662,5666268,14321481,203863,183067366
2/25/22,42894345,2665077,28484890,11057348,78181194,5672114,14511721,212966,183679655
2/26/22,42905844,2831275,28578647,11075517,78255869,5677384,14683502,251129,184259167
2/27/22,42916117,2994830,28578647,11091840,78330303,5681753,14792040,274833,184660363
2/28/22,42924130,3134456,28744050,11100651,78355971,5683434,14847515,301154,185091361
3/1/22,42931045,3273445,28768104,11108220,78374034,5684813,14976202,335876,185451739
3/2/22,42938599,3492685,28787620,11125358,78449796,5689934,15170147,368741,186022880
3/3/22,42945160,3691473,28811165,11142108,78513713,5693489,15375607,424358,186597073
3/4/22,42951556,3958326,28842160,11162434,78566505,5696611,15587564,481550,187246706
3/5/22,42957477,4212636,28904030,11182111,78617568,5699804,15777575,534418,187885619
3/6/22,42962953,4456261,28973799,11200487,78661926,5702524,15899605,572356,188429911
3/7/22,42967315,4666970,29033052,11210285,78676268,5703611,15978957,603734,188840192
3/8/22,42971308,4869672,29049013,11218784,78685193,5704498,16144185,629238,189271891
3/9/22,42975883,5212101,29069469,11238154,78742283,5707497,16391249,658103,189994739
3/10/22,42980067,5539639,29138362,11256947,78773362,5709897,16651867,684699,190734840
3/11/22,42984261,5822612,29193268,11275562,78820087,5712261,16905846,709726,191423623
3/12/22,42987875,6206263,29249903,11293062,78859305,5714473,17143616,729284,192183781
3/13/22,42990991,6556432,29305114,11309941,78895850,5716304,17298690,747072,192820394
3/14/22,42993494,6866212,29350134,11319309,78908032,5717045,17387482,761907,193303615
3/15/22,42996062,7228534,29368776,11328216,78917160,5717716,17594934,777624,193929022
3/16/22,42998938,7629264,29380063,11348915,78978484,5719931,17879513,791571,194726679
3/17/22,43001477,8250592,29432157,11368638,79002903,5721785,18186349,807432,195771333
3/18/22,43004005,8657609,29478039,11388597,79040718,5723311,18480765,818612,196591656
3/19/22,43006080,9038938,29527640,11406790,79073784,5724801,18735052,828881,197341966
3/20/22,43007841,9373646,29573112,11425352,79104505,5726113,18877836,838272,197926677
3/21/22,43009390,9582560,29617266,11434882,79114371,5726591,18966867,846296,198298223
3/22/22,43010971,9936366,29630484,11444269,79124384,5726908,19203764,853254,198930400
3/23/22,43012749,10427238,29641594,11467753,79162950,5727480,19507971,860306,199808041
3/24/22,43014687,10822718,29682615,11491503,79188026,5729137,19815558,866707,200610951
3/25/22,43016372,11162232,29729991,11513985,79233104,5730459,20101419,873944,201361506
3/26/22,43018032,11497711,29767681,11532428,79269168,5731642,20345322,879993,202041977
3/27/22,43019453,11815841,29802257,11549377,79297620,5732776,20482891,885234,202585449
3/28/22,43020723,12002874,29802257,11557639,79310111,5733154,20552413,890267,202869438
3/29/22,43021982,12350315,29842418,11564146,79319836,5733500,20758850,894914,203485961
3/30/22,43023215,12774888,29852341,11577819,79352332,5734909,21033121,899803,204248428
3/31/22,43024440,13095545,29882397,11589542,79376304,5736113,21292939,904798,204902078
4/1/22,43025775,13375818,29916334,11601177,79424524,5737262,21524553,909723,205515166
4/2/22,43027035,13639915,29947895,11611303,79464622,5738261,21706415,914831,206050277
4/3/22,43028131,13874216,29975165,11621207,79492028,5739004,21799298,919026,206448075
4/4/22,43029044,14001266,29992227,11626066,79503677,5739334,21845613,922543,206659770
4/5/22,43029839,14267350,29999437,11630078,79514210,5739609,22000514,925640,207106677
4/6/22,43030925,14553585,30012798,11642275,79541289,5740621,22211455,928994,207661942
4/7/22,43031958,14778361,30040129,11653563,79574509,5741407,22400448,932165,208152540
4/8/22,43033067,14983694,30067249,11665428,79616997,5742195,22568336,935640,208612606
4/9/22,43034217,15169189,30093751,11677223,79650898,5742946,22711086,938719,209018029
4/10/22,43035271,15333670,30123963,11689176,79693594,5743637,22787074,941545,209347930
4/11/22,43036132,15424519,30145192,11695569,79707663,5743931,22829554,944191,209526751
4/12/22,43036928,15635225,30152402,11700899,79724928,5744181,22969938,946791,209911292
4/13/22,43038016,15830618,30161205,11715663,79759235,5744953,23152600,949659,210351949
4/14/22,43039023,15979023,30183929,11729966,79787927,5745615,23311433,954346,210731262
4/15/22,43039972,16104869,30210853,11744501,79834131,5746244,23462240,959392,211102202
4/16/22,43040947,16212751,30234024,11752346,79897121,5746512,23523133,965042,211371876
4/17/22,43042097,16305752,30247302,11758719,79941120,5746736,23574810,970368,211586904
4/18/22,43044280,16353436,30250077,11766485,79957875,5746921,23608924,974858,211702856
4/19/22,43045527,16471901,30252618,11773771,79976604,5747126,23645645,979966,211893158
4/20/22,43047594,16583178,30261088,11788620,80012352,5747970,23804460,984769,212230031
4/21/22,43049974,16673997,30275219,11808366,80065941,5748538,23984254,990420,212596709
4/22/22,43052425,16755055,30311969,11826505,80123536,5749258,24140298,995928,212954974
4/23/22,43054952,16830469,30330629,11843294,80173191,5749805,24259939,1003057,213245336
4/24/22,43057545,16895194,30338697,11860099,80240246,5750364,24314395,1009091,213465631
4/25/22,43060086,16929504,30345654,11867797,80263667,5750625,24341406,1017161,213575900
4/26/22,43062569,17009839,30349463,11874582,80284714,5750944,24460311,1024544,213816966
4/27/22,43065496,17086601,30355919,11895022,80335969,5751772,24599761,1032905,214123445
4/28/22,43068799,17144048,30378061,11915904,80400384,5752427,24715624,1043544,214418791
4/29/22,43072176,17194592,30399004,11936944,80477949,5753065,24810379,1060926,214705035
4/30/22,43075864,17237878,30418920,11956517,80539609,5753636,24888640,1074853,214945917
5/1/22,43079188,17275649,30433042,11976174,80620533,5754150,24922537,1091080,215152353
5/2/22,43082345,17295622,30448236,11984673,80646427,5754364,24938267,1109144,215259078
5/3/22,43084913,17346727,30454499,11991924,80673145,5754574,25025378,1127501,215458661
5/4/22,43088118,17395772,30460997,12007969,80736423,5755375,25132303,1151123,215728080
5/5/22,43091393,17438068,30482429,12030858,80810632,5756137,25222104,1179973,216011594
5/6/22,43094938,17464782,30502501,12052731,80910357,5756861,25302593,1210601,216295364
5/7/22,43098743,17504334,30524183,12073539,80990389,5757501,25369903,1247141,216565733
5/8/22,43102194,17544398,30543908,12094042,81086012,5758216,25396739,1292048,216817557
5/9/22,43105401,17564962,30558530,12102633,81113477,5758476,25409979,1336865,216950323
5/10/22,43107689,17614869,30564536,12110099,81145154,5758727,25494954,1377637,217173665
5/11/22,43110586,17658771,30574245,12135110,81245828,5759752,25589935,1428843,217503070
5/12/22,43113413,17694635,30594388,12157510,81346211,5760207,25667402,1486396,217820162
5/13/22,43116254,17727086,30617786,12178729,81474180,5761303,25732479,1552277,218160094
5/14/22,43119112,17756627,30639130,12198261,81573081,5762284,25789409,1617603,218455507
5/15/22,43121599,17782061,30664739,12216901,81690938,5763249,25809423,1681949,218730859
5/16/22,43123801,17795312,30682094,12224441,81719914,5763634,25818999,1750942,218879137
5/17/22,43125370,17830392,30688390,12230776,81766021,5763961,25884834,1812953,219102697
5/18/22,43127199,17861719,30701900,12250365,81889410,5765343,25953018,1878918,219427872
5/19/22,43129563,17889832,30728286,12269469,82018519,5766626,26006742,1963655,219772692
5/20/22,43131822,17914937,30741811,12287087,82165298,5767991,26051087,2054311,220114344
5/21/22,43134145,17938399,30752226,12303050,82274994,5769390,26091061,2140374,220403639
5/22/22,43136371,17957697,30762413,12318193,82424908,5770735,26104819,2225239,220700375
5/23/22,43138393,17967641,30778607,12324168,82461088,5771313,26111732,2304993,220857935
5/24/22,43140068,17993967,30791220,12329139,82505831,5771856,26158839,2371470,221062390
5/25/22,43142192,18017904,30803995,12346222,82616012,5774084,26205524,2454083,221360016
5/26/22,43144820,18036703,30836815,12360376,82749361,5776109,26240853,2543690,221688727
5/27/22,43147530,18053287,30846602,12373386,82903086,5778347,26249148,2625810,221977196
5/28/22,43150215,18067669,30880512,12385004,83016109,5780448,26281799,2720563,222282319
5/29/22,43153043,18080323,30921145,12396904,83163859,5782549,26292375,2801606,222591804
5/30/22,43155749,18086447,30945384,12401946,83199689,5783461,26298797,2878333,222749806
5/31/22,43158087,18103618,30953579,12406544,83235005,5784318,26345694,2938534,222925379
6/1/22,43160832,18119415,30977661,12421499,83288965,5787647,26397221,3019343,223172583
6/2/22,43164544,18129293,31019038,12434763,83445790,5791006,26442006,3107768,223534208
6/3/22,43168585,18141803,31060017,12448195,83586375,5794548,26484415,3184902,223868840
6/4/22,43172547,18153851,31101290,12460616,83698751,5797912,26523735,3261688,224170390
6/5/22,43176817,18163686,31137479,12472487,83838051,5801415,26536513,3330038,224456486
6/6/22,43181335,18168708,31153069,12477330,83885240,5802897,26543582,3392302,224604463
6/7/22,43185049,18174842,31159335,12481682,83928350,5804190,26552882,3445556,224731886
6/8/22,43190282,18188185,31195118,12495347,84026986,5810164,26623995,3528728,225058805
6/9/22,43197522,18200335,31266163,12509484,84179296,5815789,26706062,3609157,225483808
6/10/22,43205106,18209650,31315777,12522669,84326834,5822242,26777262,3682501,225862041
6/11/22,43213435,18218078,31360850,12534389,84429363,5828328,26842481,3751164,226178088
6/12/22,43222017,18225460,31417341,12544642,84576779,5834475,26862119,3831184,226514017
6/13/22,43230101,18229278,31445137,12548421,84614265,5836988,26874274,3882284,226660748
6/14/22,43236695,18239044,31456865,12551142,84652785,5839110,26961243,3927743,226864627
6/15/22,43245517,18248463,31497038,12551142,84743740,5848751,27054749,3994394,227183794
6/16/22,43257730,18256445,31541479,12551142,84881224,5857889,27136289,4063864,227546062
6/17/22,43270577,18263643,31611769,12551142,85023863,5867615,27173073,4127625,227889307
6/18/22,43283793,18270485,31644703,12563399,85121542,5877089,27250118,4183367,228194496
6/19/22,43296692,18276552,31673375,12563399,85246567,5887145,27272916,4237585,228454231
6/20/22,43309473,18280063,31693502,12563399,85282050,5891229,27285844,4288753,228594313
6/21/22,43319396,18289349,31704193,12563399,85317181,5894682,27391084,4324935,228804219
6/22/22,43331645,18298286,31754465,12613634,85369134,5910742,27515393,4381874,229175173
6/23/22,43344958,18305766,31818827,12613634,85554781,5926685,27628425,4434825,229627901
6/24/22,43362294,18312993,31890733,12613634,85689480,5943735,27729140,4483878,230025887
6/25/22,43378234,18319773,31962782,12681820,85792166,5960706,27815495,4530391,230441367
6/26/22,43389973,18326019,32023166,12681820,85955425,5978118,27841921,4571511,230767953
6/27/22,43407046,18329423,32061959,12681820,85997380,5985055,27856323,4611936,230930942
6/28/22,43418839,18339293,32078638,12681820,86040294,5991239,27972590,4641273,231163986
6/29/22,43433345,18349746,32130316,12734038,86138416,6015498,28109810,4686285,231597454
6/30/22,43452164,18359329,32206954,12734038,86291587,6037893,28234058,4729420,232045443
7/1/22,43469234,18368857,32282879,12734038,86433615,6059653,28342278,4769367,232459921
7/2/22,43486326,18379552,32358018,12818184,86539281,6078018,28435892,4806192,232901463
7/3/22,43502429,18389611,32434063,12818184,86693726,6089586,28458170,4841957,233227726
7/4/22,43518564,18395850,32471847,12818184,86703756,6092416,28470705,4875284,233346606
7/5/22,43531650,18413988,32490422,12818184,86717355,6093827,28587911,4898960,233552297
7/6/22,43547809,18433351,32535923,12890002,86782609,6093835,28715531,4936074,233935134
7/7/22,43566739,18451862,32610514,12890002,87020037,6121808,28808614,4971965,234441541